                WWWWW         
     WWWWWWWW  WFFFFFW        
	 WFFFFFFW   WFFFW         
     WFFFFFFW  WFFFFFW        
	 WFFFFFFW   WFFFW         
	 WWWDDWWW  WFFFFFW        
      WFFFFW    WFFFW         
      WFFFFW     WDW          
      WFFFFWWW   WFW     WWWWW
      WFFFFFFFW  WFW     WFFFW
      WFFFFFFFWWWWFW     WFFFW
      WFFFFFFFDFFFFW	 WFFFW
 WWWW WFFFFFFFWWWWWW	 WFFFW
 WFFW WWWDDWWW           WFFFW
 WDWWWWOOOOOOWWWWWWWWWWWWWFFFW
 WFFDFDOOOOOODFFFFFFFFFFFFFFFW
 WFFWWWOOOOOOWWWWWWWWWWWWWFFFW
 WFFW WWWWWWWWWWWWWWWWWWWWFFFW
 WFFW                    WFFFW
 WWDW                    WFFFW
 WFFW   WWWWWWW          WFFFW
 WFFW   WOOOOOW          WWWWW
 WFFW   WOOOOOW      WWWWWW   
 WFFWWWWWWDDWWWWWWWWWWFFFFWWWWW   
 WFFDOOOOOOOOODFFFFFFFFFFFDOOOW
 WFFDOOOOOOOOODFFFFFFFFFFFWOOOW
 WWWWWWWWDDWWWWWWWWWWWWWWWWWDWW
        WFFW  WWWWWWWW     WFFW
		WFFW  WOOOOOOW    WFFFW
	   WFFFFWWWDDWWWWWWWWWWWDWW
       WFFFFDFFFFFFFFFFFFFFFFFW
	   WWDWWWWWWWWWWWWWWWWWWDWW
	   WFFFW               WFFW
	   WFFW                WFW 
	   WWW                 WWW