PPPPPPPPPPPPPP
PPPPSPPPPPPPPP
PPPPPPPPPPPPPP
PPPP[TTT]PPPPP
PPPPLCSCRTTTPP
PPPPDCCCDPSRPP
PPPPLCSCRBD}PP
PPPP{BBB}PPPPP
PPPPPPPPPPPPPP
PPPPPPSPPPPPPP
PPPPPPPP[TD]PP
PPSPPPPPLPSRPP
PPPPPPPPDPPRPP
PPPPPPPP{BB}PP
PPPPPPPPPPPPPP